1111111111111111111111111111111111
100000000000000P000C000E0000000001
1111111111111111111111111111111111