111111111111
100000000011
100000000011
100000000011
100000000011
100000000011
100000000011
100000000011
100000000011
111111111111